5 8
RRRRRRRR
R.+~...R
RL..T.TR
R.RT.T.R
RRRRRRRR
