5 8
~~~~~~~~
~....T.~
~L.+T..~
~xxT...~
~~~~~~~~
