5 8
~~~~~~~~
~TRT...~
~xT+~..~
~.L..~.~
~~~~~~~~
