5 8
~~~~~~~~
~Tx.R..~
~+~L...~
~.R~...~
~~~~~~~~
