5 9
~~~~~~~~~
~...L~.~~
~x.R~.~+~
~.RRRT+.~
~~~~~~~~~
