10 10
~~~~~~~~~~
~...R....~
~.~.~L...~
~~RTRT...~
~xTR~....~
~..~.....~
~R~R~.~.~~
~T.....~.~
~+T...+..~
~~~~~~~~~~
