10 10
TTTTTTTTTT
TR+RRRRRRT
TR......RT
TRRRRRR+RT
TR......RT
TR*RRRRRRT
TR.RRRRRRT
TR.....LRT
TRRRRRRRRT
TTTTTTTTTT