TTTTTTTTTT
TR+R.RRRRT
TR.......T
TRR.RR.+RT
TR..R..RRT
TR*RRRR.RT
TRRRR.RRRT
TRRRRRRLRT
TRR.....RT
TTTTTTTTTT