30 30
RRRRRRRRRRRRRRRRRRRRRRRRRRRRR
R...........................R
R.x........................+R
R........RRRRRRRRRRRRRRRRRRRR
R+.R...R.................R.LR
R.R..R.R.RRRRRRRRRRRRRR..R..R
R........TTTTTTTTTTTTTT..RRRR
R.R.RR......................R
R...R....TTTTTTTTTTTTTTTTTTTR
R..R.....TTTTTTTTTTTTTTTTTTTR
RRR....TTT..................R
R.....T~~~T.................R
R.....T~~~T.......*.........R
R.....T~~~T......TTTTTTTTTTTR
R.x....TTT..+....T~~~~~~~~~~R
RRRRRRRRRR.......T~~~~~~~~~~R
RTTTTTTTTR.......TTTTTTTTTTTR
R.+..T..TR..................R
R....T..TR..............x...R
RRRRRR..TR.RRRRRRRRRRRRRRRRRR
R.....+.TR.RTTTTTTTTTTTTTT..R
RTTTT...TR.RT...............R
R........R.RT.....*.TTTTTTTTR
R......RRR.RT.......TTTTTTTTR
RRRRRR.....RT.......TTTTTTTTR
R~~~~R.....RT...............R
R~~~~R.....RRRRRRRRRRRR..+..R
R.RRRRR....RRRRRRRRRRRR.....R
R.....+....R....+...........R
RRRRRRRRRRRRRRRRRRRRRRRRRRRRR