RRRRRRRRRRRRRRRRRRRRRRRRRRRRR
R......R..TT.RTRR.....~~~~~~R
R.RR+..R..TT.RTRR.....~~~~~~R
R.+RRRR...TT.RTRR.....~~~~~~R
RR.R..+...TT.RTRR...........R
RRRRRRRRR....RTRR...........R
RTTTTTTTR....RTRR...........R
RTTTTTTTR....RTRR...........R
RTTTTTTTR....RTRR...........R
RTTTTTTTR....RRRR........+..R
RRRRRRRRR......RR.TTTTTTTTT.R
R+.............RR.T~~~~~~~~RR
R*xTTTTTTTT....R..TTTTTTTTT.R
RTTTTTTTTTT.......R.........R
R+...........*RRRRRRRRRRRRR.R
RRRRRRRRRRRRRRRRRRRRRRRRRRRRR
RRRRRRRRRRRRRR..............R
R.............L.............R
R...........................R
R......RRRRRRRRRRRR.........R
R..............TTTT~~~~~~~~~R
RRRRRRRRRR.....RRRR~~~~~~~~~R
RT~~~~~~~~TR...RRRRRRRRRRRRRR
RRRRRRRRR+..................R
RRRRRRRRRRRRRRRRRRR~~~~~~~~~R
Rx...R.............~~~~~~~~~R
R....R.....RRRRRRRRRRRRRRRRRR
R...RRRRRRRRRRRRRRRRRRRRRRRRR
R..........................+R
RRRRRRRRRRRRRRRRRRRRRRRRRRRRR