20 20
RRRRRRRRRRRRRRRRRRRR
R+TTT.........RR...R
RTTTT.........RR.R.R
RTTTT.........RR.R.R
RRRRR..TTTTT.R.R.R.R
R...RRT~~~~~T..R.R.R
RR..R.T~~~~~T..R.R.R
R...R.T~~~~~T.RR.R.R
R+RRR.+TTTTTRR..RR.R
RRRRRRR....RRRRRRR.R
R....R.............R
R.........RRRRRRRR.R
R.RRRRRRRx.........R
R.R................R
R..RRRRRRRRRRRRRRR.R
RR.RRRRRRRRRRRRRRR.R
RR*R.+.............R
R.R.RRRRRRRRRRRRRRRR
RR.........R.....LRR
RRRRRRRRRRRRRRRRRRRR