20 20
RRRRRRRRRRRRRRRRRRRR
R........L.RR......R
R..RRRRRRT....RRRR.R
R.R..R...TRRRRRRRR.R
R...R.R.T+TR.RR..R.R
RRRR.R.T...T.....RRR
R..R..T.....T.R.RR.R
R...RT.......TRR..RR
R...T.........T..R.R
R..T...........T...R
R.T.............TR.R
R*T..............TRR
RTx................R
R..................R
R..................R
R.R.R.R.R.R.R.R.R.RR
R......R.R.R.......R
R.......R.R........R
R+......R+R.......+R
RRRRRRRRRRRRRRRRRRRR