TTTTTTTTTTTTTTTTTT
TH..............BT
T.S..............T
T..S.............T
T...T............T
T....T...........T
T.....T..........T
T.....*TSSSx.....T
T.....T~~~~T.....T
T.....T~~~~T.....T
T.....T~~~~T.....T
T.....T~~~~T.....T
T.....xSSST*.....T
T..........T.....T
T...........T....T
T............T...T
T.............S..T
T..............S.T
TL..............HT
TTTTTTTTTTTTTTTTTT
