TTTTTTTTT
TL..S...T
T.x.....T
T.......T
TS..S..HT
T.......T
T.......T
T.......T
TB..S...T
TTTTTTTTT