TTTTTTTTT
TH..S...T
T..SSS..T
T...x...T
T...L...T
T...x...T
T..SSS..T
T...S...T
T...B..ST
TTTTTTTTT