TTTTTTTTTTTTTTTTTTTTTTTTTTT
T.........................T
T........S................T
T......................H..T
T...*.S......TTTTT........T
T.........................T
T......................T~~T
T......L.....*.........T~~T
T......................T~~T
T......................T~~T
T.....H................T~~T
T.........................T
T......S..................T
T................S........T
T..~~~~T..................T
T..~~~~T..................T
T..~~~~T...........S......T
T..~~~~T..................T
T.........................T
T................S........T
T.........................T
T.....S...................T
T.........................T
T............H........x...T
T........................ST
TTTTT.............B.......T
T~~~~T....................T
T~~~~T...x........TTTTTT..T
T~~~~T....................T
TTTTTTTTTTTTTTTTTTTTTTTTTTT