30 30
TTTTTTTTTTTTTTTTTTTTTTTTTTTTT
TTTT.........x...........TT+T
R~~R.....................R~~R
R~~R.....................R~~R
R~~R.R...................R~~R
R~~R.......TTTT..TTTTTTTTR~~R
R~~R......R~~~~R..TTTTTTTR~~R
R~~R......R~~~~R..TTTTTTTR~~R
R~~R......R~~~~R..TTTTTTTR~~R
R~~R......R~~~~R..TTTTTTTR~~R
R~~R.......TTTT..TTTTTTTTR~~R
R~~R.....................R~~R
R~~R.....................R~~R
R~~R.....................R~~R
R~~R........L............R~~R
R~~R.....................R~~R
R~~R.....................R~~R
R~~R......TTTT...TTTTTTTTR~~R
R~~R.....R~~~~R...TTTTTTTR~~R
R~~R.....R~~~~R...TTTTTTTR~~R
R~~R.....R~~~~R...TTTTTTTR~~R
R~~R.....R~~~~R...TTTTTTTR~~R
R~~R......TTTT...TTTTTTTTR~~R
R~~R.....................R~~R
R~~R.....................R~~R
R~~R.........x......R....R~~R
R~~R.....................R~~R
R~~R.....................R~~R
RRRR.......*.............RR+R
TTTTTTTTTTTTTTTTTTTTTTTTTTTTT