TTTTTTTTTTTTTTTTTTTTTTTTTTTTTT
TSSS.........x............SSHT
T~~T......................T~~T
T~~T......................T~~T
T~~T.S....................T~~T
T~~T.......TTTT...........T~~T
T~~T......T~~~~T..........T~~T
T~~T......T~~~~T..........T~~T
T~~T......T~~~~T..........T~~T
T~~T......T~~~~T..........T~~T
T~~T.......TTTT...........T~~T
T~~T......................T~~T
T~~T......................T~~T
T~~T......................T~~T
T~~T.........L............T~~T
T~~T......................T~~T
T~~T......................T~~T
T~~T.......TTTT...........T~~T
T~~T......T~~~~T..........T~~T
T~~T......T~~~~T..........T~~T
T~~T......T~~~~T..........T~~T
T~~T......T~~~~T..........T~~T
T~~T.......TTTT...........T~~T
T~~T......................T~~T
T~~T......................T~~T
T~~T..........B......S....T~~T
T~~T......................T~~T
T~~T......................T~~T
TSSS........*.............SSHT
TTTTTTTTTTTTTTTTTTTTTTTTTTTTTT