TTTTTTTTTTTTTTTTTTTTTTTTTTTTT
TTTT.........x...........TT+T
T~~T.....................T~~T
T~~T.....................T~~T
T~~T.T...................T~~T
T~~T.......TTTT..........T~~T
T~~T......T~~~~T.........T~~T
T~~T......T~~~~T.........T~~T
T~~T......T~~~~T.........T~~T
T~~T......T~~~~T.........T~~T
T~~T.......TTTT..........T~~T
T~~T.....................T~~T
T~~T.....................T~~T
T~~T.....................T~~T
T~~T........L............T~~T
T~~T.....................T~~T
T~~T.....................T~~T
T~~T......TTTT...........T~~T
T~~T.....T~~~~T..........T~~T
T~~T.....T~~~~T..........T~~T
T~~T.....T~~~~T..........T~~T
T~~T.....T~~~~T..........T~~T
T~~T......TTTT...........T~~T
T~~T.....................T~~T
T~~T.....................T~~T
T~~T.........x......T....T~~T
T~~T.....................T~~T
T~~T.....................T~~T
TTTT.......*.............TT+T
TTTTTTTTTTTTTTTTTTTTTTTTTTTTT