TTTTTTTTTTTTTTTTTT
R...............RR
R..TTTTTTTTTTTT..R
R+.TTTTTTTTTTTT..R
R.......T........R
R..TTTTT.TTTTTT..R
RRRR....*.....RRRR
R~~~R...x....R~~~R
R~~~R........R~~~R
R+~~R.R.L..R.R~~+R
R~~~R........R~~~R
R~~~R...*....R~~~R
RRRR....x.....RRRR
R................R
R..TTTTTTTTTTTT..R
R..TTTTTTTTTTTT..R
R..TTTTTTTTTTTT..R
R................R
RR......+........R
TTTTTTTTTTTTTTTTTT