30 30
TTTTTTTTTTTTTTTTTTTTTTTTTTTTT
TR~~~~...................+.RT
TR...........TTTTT.........RT
TR.........................RT
TR..*.......TTTTT..........RT
TRT.T.T.TT.T..........TTTT.RT
TR..TT...TTTTT.......T~~~~~RT
TR.TT....LT.*........T~~~~~RT
TRT.T.TT..T..........T~~~~~RT
TRT..T....TTT........T~~~~~RT
TR...................T~~~~~RT
TR.T..................TTTT.RT
TR.........................RT
TR.TTTT..........~~~~~~~~~~RT
TRT~~~~T...TT.TT.~~~~~~~~~~RT
TRT~~~~T..T.....T~~~~~~~~~~RT
TRT~~~~T....TTT............RT
TRT~~~~TTT.T...............RT
TR.TTTT...T....T...........RT
TR...........TT............RT
TR..........T..............RT
TR.........T...............RT
TR.......TT................RT
TR+.....T...........x......RT
TR.........................RT
TRTTT......................RT
TR~~~~T....................RT
TR~~~~T.x........TTTTTT....RT
TR+~~~T.R.R.R.R...........+RT
TTTTTTTTTTTTTTTTTTTTTTTTTTTTT