TTTTTTTTTTTTTTTTTTTTTTTTTTTTTT
T............................T
T............................T
T............................T
T...*........TTTTT...........T
T.......................TTTT.T
T......................T~~~~~T
T......L.....*.........T~~~~~T
T......................T~~~~~T
T......................T~~~~~T
T......................T~~~~~T
T.......................TTTT.T
T............................T
T..TTTT......................T
T.T~~~~T.....................T
T.T~~~~T.....................T
T.T~~~~T.....................T
T.T~~~~T.....................T
T..TTTT......................T
T............................T
T............................T
T............................T
T............................T
T.....................x......T
T............................T
TTTTT........................T
T~~~~T.......................T
T~~~~T...x........TTTTTT.....T
T~~~~T.......................T
TTTTTTTTTTTTTTTTTTTTTTTTTTTTTT