TTTTTTTTTT
TL..TRRRRT
TRx.....RT
TR......RT
TRTTTTTRRT
TR......RT
TR......RT
TR+.T...RT
TRRRRRRRRT
TTTTTTTTTT