TTTTTTTTTT
TH..S...RT
T..SSS..RT
T...x...RT
T...L...RT
T...x...RT
T..SSS..RT
T...S...RT
T...B..SRT
TTTTTTTTTT