TTTTTTTTTT
TL..T...RT
T.x.....RT
T.......RT
TTTTTTTRRT
T.......RT
T.......RT
T.......RT
T+..T...RT
TTTTTTTTTT