TTTTTTTTTTTTTTTTTT
TTRRRRRRRRRRRRR+.T
TRT.......T~~~~~~T
TR.T......T~~~~~~T
TR..T.....T~~~~~~T
TR...T.....TTTTT.T
TR....T.........RT
TR....*TTTTx....RT
TR....T~~~~T....TT
TR....T~~~~T....TT
TR....T~~~~T....RT
TR....T~~~~T....RT
TR....xTTTT*....RT
TR.........T....RT
TR..........T...RT
TR...........T..RT
TR............T.RT
TL.............TRT
TRRRRRRRRRRRRRRRTT
TTTTTTTTTTTTTTTTTT