TTTTTTTTTTTTTTTTTT
TT.............+.T
T.T.......T~~~~~~T
T..T......T~~~~~~T
T...T.....T~~~~~~T
T....T.....TTTTT.T
T.....T..........T
T.....*TTTTx.....T
T.....T~~~~T.....T
T.....T~~~~T.....T
T.....T~~~~T.....T
T.....T~~~~T.....T
T.....xTTTT*.....T
T..........T.....T
T...........T....T
T............T...T
T.............T..T
T..............T.T
TL..............TT
TTTTTTTTTTTTTTTTTT