TTTTTTTTTTTTTTTTTTTTTTTTTTTTT
T~~~~~....................+.T
T............TTTTTT.........T
T...........................T
T...*.......TTTTT...........T
T.T.T.T.TT.T...........TTTT.T
T...TT...TTTTT........T~~~~~T
T..TT....LT.*.........T~~~~~T
T.T.T.TT..T...........T~~~~~T
T.T..T....TTTT........T~~~~~T
T.....................T~~~~~T
T..T...................TTTT.T
T...........................T
T..TTTT..........~~~~~~~~~~~T
T.T~~~~T...TT.TT.~~~~~~~~~~~T
T.T~~~~T..T.....T~~~~~~~~~~~T
T.T~~~~T....TTT.............T
T.T~~~~TTT.T................T
T..TTTT...T....T............T
T............TT.............T
T...........T...............T
T..........T................T
T........TT.................T
T.+.....T............x......T
T...........................T
TTTTT.......................T
T~~~~T......................T
T~~~~T..x........TTTTTT.....T
T+~~~T..R.R.R.R............+T
TTTTTTTTTTTTTTTTTTTTTTTTTTTTT