10 10
TTTTTTTTTT
T+..T...RT
T..TTT..RT
T..Tx...RT
T..TL...RT
T..Tx...RT
T..TTT..RT
T...T...RT
T..TT.*TRT
TTTTTTTTTT