TTTTTTTTTTTTTTTTTT
TS.....SSS......HT
T................T
T................T
T................T
T................T
TTTTS...*....STTTT
T~~~T........T~~~T
T~~~T........T~~~T
T~~~T...L....T~~~T
T~~~T........T~~~T
T~~~T........T~~~T
TTTTS...x....STTTT
T................T
T................T
T................T
T................T
T................T
TH......SSS.....ST
TTTTTTTTTTTTTTTTTT