TTTTTTTTTT
TL..S...RT
T.x.....RT
T.......RT
TS..S..HRT
T.......RT
T.......RT
T.......RT
TB..S...RT
TTTTTTTTTT