TTTTTTTTTTTTTTTTTT
T...............TT
T................T
T+...............T
T................T
T................T
TTTT....*.....TTTT
T~~~T...x....T~~~T
T~~~T........T~~~T
T+~~T.R.L..R.T~~+T
T~~~T........T~~~T
T~~~T...*....T~~~T
TTTT....x.....TTTT
T................T
T................T
T................T
T................T
T................T
TT......+........T
TTTTTTTTTTTTTTTTTT