5 8
RRRRRRRR
R.L~..RR
Rx..~..R
R....~RR
RRRRRRRR
