5 8
RRRRRRRR
R..T...R
R+.LT..R
R.x.RT.R
RRRRRRRR
