5 8
RRRRRRRR
RT.....R
RxT+...R
R.LT...R
RRRRRRRR
