20 20
TTTTTTTTTTTTTTTTTTTT
T.T..+..R..~..x..*.T
T.RRRRRR..T..RRRRR.T
T.T~~~~~T..T..+....T
T.T~~~~~T..RRRRR..RT
T.T~~~~~T..T....*.RT
T.TTTTTTT..T..RRRRRT
T...RRR....T..+....T
T..+..T..RRRRRRRRR.T
T.RRRRT..T..T......T
T.T....T..T..x.....T
T.T..x.T..T..RRRRRRT
T.Tx...T..RRRRRRRRRT
T.RRRRRRRR..+......T
T....+....RRRRRRRR.T
T.RRRRRRR..T..x..R.T
T.T~~~~~T..T..+..R.T
T.T~~~~~T..RRRR.RR.T
T.T~~~~~T.LT....*.RT
TTTTTTTTTTTTTTTTTTTT