30 30
RRRRRRRRRRRRRRRRRRRRRRRRRRRRR
T.LTTTTTTTTTRRRRRRRRRRRRRRRRT
T.TTTTTTTTTRTTTTT.......RRRRT
T.TTTTTTTTTRT....+......R..RT
T.T...T...T.R........RRRR..RT
T...T...T...R....x..R....*.RT
RRRRRRRRRRRRRRRRRRRRRRRRRRRRR
T+....RRRRRRRRRRRRRRR..RR...T
TRRR.R.................RRRR.T
TRRR..x....RRRRRRRRRRR....*.T
TRRRRRR....RRRRRRRRRRR......T
TRRRR.R.+..RRRRRRRRRRR......T
RRRRRR.RRRRRRRRRRRRRRRRRRRRRR
T....RRRRRRRRRRRRRRRRRRRRR..T
T....R.RRRRRRRRRRRRRRRRRRR+.T
T....R.RRRRRRRRRRRRRRRRR.R..T
T..+..~RRRRRRRRRRRRRRRRRRRR.T
RRRRRRRRRRRRRRRRRRRRRRRRR.RRR
T..RRRRRRRRRRRRRRRRRRRRRR~R.T
T.+RRRRRRRRRRRRRRRRRRRRRR.+.T
T..RRRRRRR~~~~~~~~RRRRRRR.*.T
T..RRRRRRR~~~~~~~~RRRRRRRRR.T
RRRRRRRRRR~~~~~~~~RRRRRRRRRRR
T..RRRRRRRRRRRRRRRRRRRRRRRR.T
T..RRRRRRRRRRRRRRRRRRRRRRRR.T
T.....+..RRRRRRRRRRRRRRRRRR.T
T..RRRRRRRRRRRRRRRRRRRRRRRR.T
T..RRRRRRRRRRRRRRRRRRRRRRRR.T
T..RRRRRRRRRRRRRRRRRRRRRRR+~T
RRRRRRRRRRRRRRRRRRRRRRRRRRRRR