30 30
RRRRRRRRRRRRRRRRRRRRRRRRRRRRRR
R..............+...........xR
R..RRRRRRRRRRRRRRRRRRRRRRR..R
R..R......................R.R
R..R..TTTTTTTTTTTTTTTTTTT.R.R
R..R..T~~~~~~~~~~~~~~~T...R.R
R..R..T~~~~~~~~~~~~~~~T...R.R
R..R..TTTTTTTTTTTTTTTTT...R.R
R..R......................R.R
R..RRRRRRRRRRRRRRRRRRRRRRRR.R
R...........................R
R...*.......................R
R..RRRRRRRRRRRRRRRRRRRRRRR..R
R..R.......................+R
R..R..TTTTTTTTTTTTTTTTTTT..RR
R..R..T~~~~~~~~~~~~~~~T...TRR
R..R+.T~~~~~~~~~~~~~~~T...TRR
R..R..TTTTTTTTTTTTTTTTT...TRR
R..R......................TRR
R..RRRRRRRRRRRRRRRRRRRRRR.TRR
R..........................TR
R...x......................TR
R..RRRRRRRRRRRRRRRRRRRRRRR..R
R..R......................R.R
R..R..TTTTTTTTTTTTTTTTTT..R.R
R.+R..T~~~~~~~~~~~~~~~T...R.R
R..R..T~~~~~~~~~~~~~~~T...R.R
R..R..TTTTTTTTTTTTTTTTT...R.R
R..R..............L.......R+R
RRRRRRRRRRRRRRRRRRRRRRRRRRRRR