10 10
TTTTTTTTTT
TR+RRRRRRT
TR..R...RT
TR.RR.R.RT
TRR.R.R.RT
TR*.R.R.RT
TR.RR.R.RT
TR..x+RLRT
TRRRRRRRRT
TTTTTTTTTT