TTTTTTTTTT
TR.RRRRRRT
TR.R....RT
TR......RT
TRRR+RRRRT
TR.TTTT.RT
TR.RRRR.RT
TR..L...RT
TRRRRRRRRT
TTTTTTTTTT