20 20
TTTTTTTTTTTTTTTTTTTT
T....R....+....R...T
T..RRRRRRRRRRRRRRR.T
T..T~~~~~T.....x..RT
T..T~~~~~T.........T
T..T~~~~~T..RRRRR..T
T..TTTTTTT..T....*.T
T.........RRR......T
T..+......T..RRRRRRT
T..RRRRRRRT..T.....T
T..T......T..T..+..T
T..T..x...TL.T.....T
T..T......T..RRRRRRT
T..RRRRRRRRR.......T
T....+............RT
T..RRRRRRRRRRRRRRR.T
T..T~~~~~T.....x..RT
T..T~~~~~T.........T
T..T~~~~~T..RRRRR..T
TTTTTTTTTTTTTTTTTTTT