RRRRRRRRRRRRRRRRRRRRRRRRRRRRR
T.LTTTTTTTTT................T
T.TTTTTTTTTT.TTTTT..........T
T.TTTTTTTTTT.T....+.........T
T.T...T...T..T..............T
T...T...T...T........x....*.T
RRRRRRRRRRRRRRRRRRRRRRRRRRRRR
T+..........................T
T...........................T
T.....x...................*.T
T...........................T
T.....+.....................T
RRRRRRRRRRRRRRRRRRRRRRRRRRRRR
T...........................T
T.....................+.....T
T...........................T
T..+........................T
RRRRRRRRRRRRRRRRRRRRRRRRRRRRR
T...........................T
T.+......................+..T
T............*..............T
T...........................T
RRRRRRRRRRRRRRRRRRRRRRRRRRRRR
T...........................T
T...........................T
T...........+...............T
T...........................T
T...........................T
T..........................+T
RRRRRRRRRRRRRRRRRRRRRRRRRRRRR