TTTTTTTTTTTTTTTTTT
T........T.......T
T........~.......T
T.x......T.......T
T..TT....T....+..T
T.T+T....T.......T
T.TT.....TTTTTTTTT
T........R.......T
T................T
T...........*....T
T...TT...........T
T.....T..........T
T......T.......TTT
TTTT...TTTT......T
T...T....~.T..R..T
T.L.T...TT.....T~T
T...TTT..T....T+.T
T........T....T..T
T........T....T..T
TTTTTTTTTTTTTTTTTT