TTTTTTTTTTTTTTTTTT
T........T....T~+T
T........R....T~~T
T.T......T.....TTT
T.+TT....T...R...T
T.TTT....T.......T
T.TT.....R.......T
T................T
T................T
T...........*....T
T..TTT...........T
T.....T..R.......T
T......T....TTTTTT
T......TTTT......T
T...T+.....T.TT..T
T.T.T...TT.....T.T
T...TT...T....T..T
T...TT...T....T..T
T........T....TL.T
TTTTTTTTTTTTTTTTTT