TTTTTTTTTTTTTTTTTTTT
T........T.........T
T........~.........T
T.x......T.........T
T..TT....T....+....T
T.T+T....T.........T
T.TT.....TTTTTTTTTTT
T........R.........T
T..................T
T...........*......T
T...TT.............T
T.....T............T
T......T.......TTTTT
TTTT...TTTT.......RT
T...T....~.T..R...RT
T.L.T...TT.....T..RT
T...TTT..T....T+..RT
T........T....T...RT
T........T....T...RT
TTTTTTTTTTTTTTTTTTTT