20 20
TTTTTTTTTTTTTTTTTTTT
RRRRRRRRRRRRRRRRRRRR
TR.......T......T~+T
TR.......R......T~~T
TR+TT....T.....R...T
TRTTT....T.........T
TRTT.....R.........T
TR.................T
TR.................T
TR............*....T
TR.TTT.............T
TR....T..R.........T
TR.....T......TTTTRT
TR.....TTTT........T
TR..T+.......T.TT..T
TRT.T...TT.......T.T
TR..TT...T......T..T
TR..TT...T......TL.T
TRRRRRRRRRRRRRRRRRRT
TTTTTTTTTTTTTTTTTTTT