TTTTTTTTTTTTTTTTTTTTTTTTTTTTTT
T.+T.................TT.....T
T.TTTTTTTTTTTTTT.....TT.....T
T...T...........T....TT.....T
T.....L.........T....TT*....T
T....TTTTTTTTTT.T.....TTTTTTT
T.....................T~~~~~T
T.....................T~~~~~T
T...........RT........T~~~~~T
T...TTTTT.............TTTTTTT
T...T.......x......TTT......T
T......T....................T
T...R........TTTTT..R.......T
T...T.....TTTTT.............T
T...T.....T..*.......TTTTTTTT
T...T................T......T
T...T................T+.....T
T...TT..TTTTTT.......T......T
T...........T.........TT....T
T..TTT......................T
T.........TTTTTTT...........T
T.........T.................T
T.........T.................T
T........TTTT...............T
T.TT....TT~.........TTTTTTTTT
T.TT................T+......T
T...........*..TTTTTT.......T
T.........TTTT.T+...T.......T
T...........................T
TTTTTTTTTTTTTTTTTTTTTTTTTTTTT