TTTTTTTTTTTTTTTTTTTTTTTTTTTTT
T..T...+..T.....T...+.......T
T..T......T.....T...........T
T..TTT....T.....T...~.......T
T.........T.......~.........T
T..~......T....R............T
T......TTTT.................T
T...............TTTTT.......T
T.*TTTT...T.................T
T..Tx........T....TTTT......T
T..T.........T..............T
T..T.........T~.............T
T..T.........T.T.R..........T
T............T+.TT..........T
T............TTT............T
T...TTTTT...................T
T...T.......x.....TTT.......T
T...........................T
T...R.......TTTTT..R........T
T...T.......................T
T...TTTTTT....T.............T
T........T.........TTT......T
T........T.........T........T
T........T..TT.....T........T
T........T.........T........T
T...TTT..T.........TT.RRRRTTT
T..L..TT.T........T...~.....T
T..TTT............TTTT+.....T
T.......TTT*......T.........T
TTTTTTTTTTTTTTTTTTTTTTTTTTTTT