TTTTTTTTTT
T.....~+RT
T...R.TTRT
T.....T.RT
T.x.....RT
T.~.....RT
T.~.....RT
T..*TTT.RT
TL......RT
TTTTTTTTTT