20 20
RRRRRRRRRRRRRRRRRRRR
R........T.........R
R........~.........R
R.x......T.........R
R..TT....T....+....R
R.T+T....T.........R
R.TT.....TTTTTTTTTTR
R........R.........R
R..................R
R...........*......R
R...TT.............R
R.....T............R
R......T.......TTTTR
RTTT...TTTT.......RT
R...T....~.T..R...RT
R.L.T...TT.....T..RT
R...TTT..T....T+..RT
R........T....T...RT
R........T....T...RT
TTTTTTTTTTTTTTTTTTTT