10 10
TTTTTTTTTT
T...+...RT
T...~...RT
T...R.T.RT
T.T.LTT.RT
T.x...*.RT
T.......RT
T.......RT
T.......RT
TTTTTTTTTT