TTTTTTTTTTTTTTTTTTTTTTTTTTT
T...........+B+...........T
T.........................T
T.........TTT.TTT.........T
T........T~~~T~~~T........T
T.........T~~~~~T.........T
T..........T~~~T..........T
T...........T.T...........T
T............T............T
Tx...........+...........*T
TTTTTTTTTTTT~~~TTTTTTTTTTTT
T~~~~~~~~~~~~~~~~~~~~~~~~~T
T~~~~~~~~~~~~~~~~~~~~~~~~~T
T~~~~~~~~~~~~~~~~~~~~~~~~~T
T~~~~~~~~~~~~~~~~~~~~~~~~~T
T~~~~~~~~~~~~~~~~~~~~~~~~~T
TTTTTTTTTTTT~~~TTTTTTTTTTTT
T~~~T..R.R.R.R.R.R.R..T~~~T
T~~~T........+........T~~~T
T~~~T.................T~~~T
T~~~T.................T~~~T
T~~~T.................T~~~T
TTTT...................TTTT
T.........................T
TTTTTTT.............TTTTTTT
T....T...............T....T
T...T.................T...T
T..T...................T..T
T.T..........L..........T.T
TTTTTTTTTTTTTTTTTTTTTTTTTTT