TTTTTTTTTTTTTTTTTT
T...............BT
T.+..............T
T....TTTTTTTTTTTTT
T...............+T
T............TTTTT
T................T
T................T
T................T
T*...............T
T................T
T................T
T................T
T+.....x.........T
TTTTTTT~~~~~~~~~~T
T.....T~~~~~~~~~~T
T..RR.T~~~~~~~~~~T
T.....R..........T
TL...............T
TTTTTTTTTTTTTTTTTT