TTTTTTTTT
TL......T
T...~...T
T.....T.T
TTTTRTT.T
T.x...*+T
T.......T
T.......T
TB......T
TTTTTTTTT