TTTTTTTTT
T.....~+T
TTTTRTTTT
T.....TTT
T...Bx..T
T.~.....T
T.~.....T
T..*TTTTT
TL...T~~T
TTTTTTTTT