TTTTTTTTTTTTTTTTTT
T....T.....TTTT..T
T.+..T...........T
T~~~~T......+....T
T................T
T................T
T....R...........T
T....RTTTTT+.....T
T....T~~~~~T.....T
T....T~~B~~T....RT
T....T~~~~~T....RT
T.....TTTTT.....RT
T..............R.T
T................T
T..........TTTTTTT
T.........*T.....T
T+....TTTTT.....xT
TTTTTT....TTTTTT.T
TL.....TT........T
TTTTTTTTTTTTTTTTTT