TTTTTTTTTTTTTTTTTTTT
T....T.....TTTT....T
T.+..T.............T
T~~~~T......+......T
T..................T
T..................T
T....R.............T
T....RTTTTT+.......T
T....T~~~~~T.......T
T....T~~B~~T....R..T
T....T~~~~~T....R..T
T.....TTTTT.....R..T
T..............R...T
T..................T
T..........TTTTTTTTT
T.........*T.......T
T+....TTTTT.....x..T
TTTTTT....TTTTTT...T
TL.....TT..........T
TTTTTTTTTTTTTTTTTTTT