TTTTTTTTTTTTTTTTTTTTTTTTTTTTT
T+T.T.T..........+T~~~~~~~~~T
T..T.T............T~~~~~~~~~T
T.T.T.T............T~~~~~~~~T
TT.T.T..............T~~~~~~~T
T...................+T~~~~~~T
T.....................T~~~~~T
T......................T~~~~T
T.......................T~~~T
T..........T.............T~~T
T........*T~T.............T~T
T.......T~~~~T.............TT
T......T~~~~~~T.............T
T.....T~~~~~~~~T............T
T....T~~~~~~~~~~T...........T
T.....T~~~~~~~~~~T..........T
T......T~~~~~~~~~~T.........T
T.......T~~~~~~~~~~T........T
T+.......T~~~~~~~~T.........T
TT........T~~~~~~T..........T
T~T........T~~~~Tx..........T
T~~T........T~~T............T
T~~~T........TT.............T
T~~~~T......T.TTTTTTTTTTTTTTT
T~~~~~T.....T...............T
T~~~~~~T...T..TTTTTTTTTTTT..T
T~~~~~~~T..T.T..............T
T~~~~~~~~T...T.TTTTTTTTTTTTTT
T~~~~~~~~~T..T..........LTTTT
TTTTTTTTTTTTTTTTTTTTTTTTTTTTT