TTTTTTTTTTTTTTTTTTTTTTTTTTTTTT
T+T.T.T...........+T~~~~~~~~~T
T..T.T.............T~~~~~~~~~T
T.T.T.T.............T~~~~~~~~T
TT.T.T...............T~~~~~~~T
T....................+T~~~~~~T
T......................T~~~~~T
T.......................T~~~~T
T........................T~~~T
T...........T.............T~~T
T.........*T~T.............T~T
T........T~~~~T.............TT
T.......T~~~~~~T.............T
T......T~~~~~~~~T............T
T.....T~~~~~~~~~~T...........T
T......T~~~~B~~~~~T..........T
T.......T~~~~~~~~~~T.........T
T........T~~~~~~~~~~T........T
T+........T~~~~~~~~T.........T
TT.........T~~~~~~T..........T
T~T.........T~~~~Tx..........T
T~~T.........T~~T............T
T~~~T.........TT.............T
T~~~~T.......................T
T~~~~~T......................T
T~~~~~~T.....................T
T~~~~~~~T....................T
T~~~~~~~~T......TTTTTTTTTTTTTT
T~~~~~~~~~T..............LTTTT
TTTTTTTTTTTTTTTTTTTTTTTTTTTTTT