TTTTTTTTTTTTTTTTTTTT
T~~~~~R..........~~T
T~~~~~R.........+~~T
TRRRRRRRTTTTTTTTTTTT
T.................+T
T.........RTTTTTTTRT
T.........T~~~~~~~RT
T.........T~~~~~~~RT
T.........T~~~~~~~RT
T*........TTTTTTTTRT
T.................RT
T.................RT
T.................RT
T+.....x....TTTTTTTT
TTTTTTT~~~~~~~~~~~~T
T.....T~~~~~~~~~~~~T
T..RR.T~~~~~~~~~~~~T
T.....R............T
TL.................T
TTTTTTTTTTTTTTTTTTTT