20 20
TTTTTTTTTTTTTTTTTTTT
TR...T.....TTTT...TR
TR+..T.............R
TR~~~T......+......R
TR.................R
TR.................R
TR...R.............R
TR...RTTTTT+.......R
TR...T~~~~~T.......R
TR...T~~~~~T....R..R
TR...T~~~~~T....R..R
TR....TTTTT.....R..R
TR.............R...R
TR.................R
TR.........TTTTTTTTR
TR........*T.......R
T+....TTTTT.....x..R
TRTTTT....TTTTTT...R
TL.....TT..........R
TTTTTTTTTTTTTTTTTTTT