TTTTTTTTTT
T.....~+RT
TTTTRTTTTT
T.....TTRT
T...Bx..RT
T.~.....RT
T.~.....RT
T..*TTTTRT
TL...T~~RT
TTTTTTTTTT