TTTTTTTTTT
TL......RT
T...~...RT
T.....T.RT
TTTTRTT.RT
T.x...*+RT
T.......RT
T.......RT
TB......RT
TTTTTTTTTT